.W..W........W...W..
.WWWW.W.WWW.WWW..W..
......W.W.....WW...W
..A...W.WW.......W.W
WWWWW.W..W...W.W.W..
....W.W..WWW.W.W.W..
....W.W..W.WWWWW.WW.
.WW.W.WWWW..W.W...W.
..W.W.W..W....W...W.
..W...W..WW.W....WW.
WWW...W.....WWW.WW..
....WWWWWWWWW.W..W..
..W.W.....W.W.WWWW..
.WWWW..WW......W.WWW
..W....W...WW.......
W.WWW.WW.WWWW.W.WWWW
W.....W..W..W.W.W..W
W.WWWWW..WW.W.WWW..W
W...........W.....BW
WWWWWWWWWWWWW.WWWWWW
